id,group_number,res_type,res_id,res_number,res_data,rate,stock,number_item_can_buy,money_type,money_value
1,1,3,1014,1,,1,1,1,41,300
2,1,3,2014,1,,1,1,1,41,300
3,1,3,3014,1,,1,1,1,41,300
4,1,3,4014,1,,1,1,1,41,300
5,1,2,40,2,,1,1,1,41,100
6,1,2,40,2,,1,1,1,41,100
7,1,2,40,2,,1,1,1,41,100
8,1,2,40,2,,1,1,1,41,100
