id,group_number,res_type,res_id,res_number,res_data,rate,stock,number_item_can_buy,money_type,money_value
1,1,2,80,400,,1,2,2,46,64
2,1,2,80,400,,1,2,2,46,64
3,1,17,202,1,,1,2,2,46,200
4,1,17,202,1,,1,2,2,46,200
5,1,2,45,1,,1,1,1,46,50
6,1,2,45,1,,1,1,1,46,50
7,1,2,45,1,,1,1,1,46,50
8,1,2,45,1,,1,1,1,46,50
