id,group_number,res_type,res_id,res_number,res_data,rate,stock,number_item_can_buy,money_type,money_value
1,1,3,1021,1,,1,1,1,41,2500
2,1,3,2021,1,,1,1,1,41,2500
3,1,3,3021,1,,1,1,1,41,2500
4,1,3,4021,1,,1,1,1,41,2500
5,1,2,40,8,,1,1,1,41,400
6,1,2,40,8,,1,1,1,41,400
7,1,2,40,8,,1,1,1,41,400
8,1,2,40,8,,1,1,1,41,400
