id,group_number,res_type,res_id,res_number,res_data,rate,stock,number_item_can_buy,money_type,money_value
1,1,2,80,5000,,1,2,2,46,800
2,1,2,80,5000,,1,2,2,46,800
3,1,17,202,8,,1,2,2,46,1600
4,1,2,25,4,,1,2,2,46,3200
5,1,2,45,8,,1,1,1,46,400
6,1,2,45,8,,1,1,1,46,400
7,1,2,45,8,,1,1,1,46,400
8,1,2,45,8,,1,1,1,46,400
