id,group_number,res_type,res_id,res_number,res_data,rate,stock,number_item_can_buy,money_type,money_value
1,1,3,1016,1,,1,1,1,41,600
2,1,3,2016,1,,1,1,1,41,600
3,1,3,3016,1,,1,1,1,41,600
4,1,3,4016,1,,1,1,1,41,600
5,1,2,40,4,,1,1,1,41,200
6,1,2,40,4,,1,1,1,41,200
7,1,2,40,4,,1,1,1,41,200
8,1,2,40,4,,1,1,1,41,200
