id,group_number,res_type,res_id,res_number,res_data,rate,stock,number_item_can_buy,money_type,money_value
1,1,2,80,1000,,1,2,2,46,160
2,1,2,80,1000,,1,2,2,46,160
3,1,17,202,2,,1,2,2,46,400
4,1,17,202,2,,1,2,2,46,400
5,1,2,45,2,,1,1,1,46,100
6,1,2,45,2,,1,1,1,46,100
7,1,2,45,2,,1,1,1,46,100
8,1,2,45,2,,1,1,1,46,100
