id,group_number,res_type,res_id,res_number,res_data,rate,stock,number_item_can_buy,money_type,money_value
1,1,3,1017,1,,1,1,1,41,1200
2,1,3,2017,1,,1,1,1,41,1200
3,1,3,3017,1,,1,1,1,41,1200
4,1,3,4017,1,,1,1,1,41,1200
5,1,2,40,8,,1,1,1,41,400
6,1,2,40,8,,1,1,1,41,400
7,1,2,40,8,,1,1,1,41,400
8,1,2,40,8,,1,1,1,41,400
