id,group_number,res_type,res_id,res_number,res_data,rate,stock,number_item_can_buy,money_type,money_value
1,1,2,80,2000,,1,2,2,46,320
2,1,2,80,2000,,1,2,2,46,320
3,1,17,202,2,,1,2,2,46,400
4,1,2,25,1,,1,2,2,46,800
5,1,2,45,2,,1,1,1,46,100
6,1,2,45,2,,1,1,1,46,100
7,1,2,45,2,,1,1,1,46,100
8,1,2,45,2,,1,1,1,46,100
