id,group_number,res_type,res_id,res_number,res_data,rate,stock,number_item_can_buy,money_type,money_value
1,1,2,80,3000,,1,2,2,46,480
2,1,2,80,3000,,1,2,2,46,480
3,1,17,202,4,,1,2,2,46,800
4,1,2,25,2,,1,2,2,46,1600
5,1,2,45,4,,1,1,1,46,200
6,1,2,45,4,,1,1,1,46,200
7,1,2,45,4,,1,1,1,46,200
8,1,2,45,4,,1,1,1,46,200
